22 8 21 4 0 4
+------+-------------+
|      |             |
|      |      |      |
|      |      |      |
F      |      |      S
|             |      |
|             |      |
+-------------+------+