22 8 20 20
+------+-------------+
|      |             |
|      |      |      |
|      |      |      |
F      |      |      S
|             |      |
|             |      |
+-------------+------+
A 5 10 10  
B 6 15 11
C 4 20 15
# 2 5 30

1
01736634355506192958