90 19 20 20
+---------------+------------------------------------------------------------------------+
|               |                                                                        |
|                                                                                        |
|               |                                                                        |
|               |                                                                        |
|               +----------------+                                                       |
|                     |          |                                                       |
|                                |                                                       |
|                     |          |                    ------------------------+          |
|                     |          |                                            |          |
|                     |          |                                            |          |
|                     |          |                                            |          |
|                     |          |                                            |          |
|                     |          + ------------------------- ----------       |          |
|                     |          |                                            |          |
|                     |          |                                            |          |
|                     |          +-                                           |          |
|                     |                                                       |          |
+F--------------------+-------------------------------------------------------+---S------+
A 5 5 10
Attacks enemy closest to finish.
B 6 6 15
Attacks unit in range with smallest health remaining.
C 4 8 15
Tower has 10% chance of striking critical damage to unit closest to finish in range and killing it instantly.
# 5 5 30

07924367101473705202